====================
=                  =
=                  =
=   ====    ====   =
=                  =
=                  =
=   ====    ====   =
=                  =
=                  =
=                  =
=                  =
=                  =
=   ====    ====   =
=                  =
=                  =
=                  =
=   ====    ====   =
=                  =
=                  =
====================
