====================
=          =   =   =
=          =   =   =
=  == ==           =
=            =     =
=  == ==     =     =
=                 ==
=          ====    =
=   ====           =
=                  =
==        =======  =
=         =     =  =
=   ==    =  =  =  =
=   ==    =     =  =
=         =  =  =  =
=                  =
=   =  =           =
=   =  =           =
=   =  =     =     =
====================