====================
=                  =
=                  =
=      === ===     =
=      =     =     =
=      =     =     =
=      === ===     =
=                  =
=                  =
=                  =
=                  =
=                  =
=      =    =      =
=      =    =      =
=      ======      =
=      =    =      =
=      =    =      =
=                  =
=                  =
====================