====================
=                  =
=         =        =
=         =        =
=      =======     =
=         =        =
=         =        =
=                  =
=                  =
=                  =
=                  =
=                  =
=                  =
=                  =
=                  =
=                  =
=                  =
=                  =
=                  =
====================
